11111111111111111111111111111111111111111
10M00000000000C00000000000000000000000001
10000000000000000000000000000000000000001
100E0C0000C00M111111100111111111111111001
10000000000000111111100111111111111111001
10000000000111111110000111110011111111001
10000000000111111110000111100011111111001
10000000011111110000000110000011111111001
10000000011111110000000100000011111111001
1000001111111100000C000000000011111110001
10000011111111000000000000000011111110001
10001111111000000M00000000011111111000001
100011111110000000000000000111111110000M1
1001111110000000000M000001111111000000001
1001111110000000000000000111111100M000001
1001111000P0000C0C00000111111100000000001
10011110000000000000000111111100000000001
10011111111111111111100111111100000111001
10011111111111111111100111111100000111001
10011111111111111111100111111100011111001
10011111111111111111100111111100011111001
10000000000000111111100111111101111111001
1000000000000M111111100111111101111111001
10000000C00000111111100000000000000000001
10000000000000111111100000000000000000001
1M000000000000111111100000000000000000001
100000000000000000000MM0M0000000000000001
11111111111111111111111111111111111111111
